label	about
Fish abundance	fish/abundance
Fish distribution	dish/distribution
Fish abundance by size/age/stage	fish/abundance/by_size_age_stage
Fish biomass by size/age/stage	fish/biomass/by_size_age_stage
Fish genetic composition	fish/genetic_composition
Fish genetic composition - effective population	 fish/genetic_composition/effective_population_size
Fish genetic composition - genetic differentiation	fish/genetic_composition/genetic_differentiation
Fish genetic composition - genetic diversity	fish/genetic_composition/genetic_diversity
Fish genetic composition - inbreeding	fish/genetic_composition/inbreeding
Fish species traits	fish/traits
Fish species traits - morphology	fish/traits/morphology
Fish species traits - physiology	fish/traits/physiology
Fish species traits - phenology	fish/traits/phenology
Fish species traits - movement	fish/traits/movement
Fish community composition	fish/community_composition
Fish community composition - community abundance	fish/community_composition/abundance
Fish community composition - taxonomic/phylogenetic diversity	fish/community_composition/phylogenetic_diversity
Fish community composition - trait diversity	fish/community_composition/trait_diversity
Fish community composition - interaction diversity	fish/community_composition/interaction_diversity
Fish ecosystem functioning	fish/ecosystem_functioning
Fish ecosystem functioning - primary productivity	fish/ecosystem_functioning/primary_productivity
Fish ecosystem functioning - ecosystem phenology	fish/ecosystem_functioning/ecosystem_phenology
Fish ecosystem functioning - ecosystem disturbances	fish/ecosystem_functioning/ecosystem_disturbances
Fish ecosystem structure	fish/ecosystem_structure
Fish ecosystem structure - ecosystem distribution	fish/ecosystem_structure/ecosystem_distribution
Hard coral cover	coral/cover
Hard coral condition	coral/condition
Hard coral diversity	coral/diversity
Hard coral total habitable substrate	coral/total_habitable_substrate
Hard coral size classes	coral/size_classes
Hard coral genetic composition	coral/genetic_composition
Hard coral genetic composition - effective population size	coral/genetic_composition/effective_population_size
Hard coral genetic composition - genetic differentiation	coral/genetic_composition/genetic_differentiation
Hard coral genetic composition - genetic diversity	coral/genetic_composition/genetic_diversity
Hard coral species traits	coral/traits
Hard coral species traits - morphology	coral/traits/morphology
Hard coral species traits - physiology	coral/traits/physiology
Hard coral species traits - phenology	coral/traits/phenology
Hard coral community composition	coral/composition
Hard coral community composition - community abundance	coral/composition/abundance
Hard coral community composition - taxonomic/phylogenetic diversity	coral/composition/taxonomic_phylogenetic_diversity
Hard coral community composition - trait diversity	coral/composition/trait_diversity
Hard coral community composition - interaction diversity	coral/composition/interaction_diversity
Hard coral ecosystem functioning	coral/ecosystem_functioning
Hard coral ecosystem functioning - ecosystem phenology	coral/ecosystem_functioning/ecosystem_phenology
Hard coral ecosystem functioning - ecosystem disturbances	coral/ecosystem_functioning/ecosystem_disturbances
Hard coral ecosystem structure	coral/ecosystem_structure
Hard coral ecosystem structure - live cover fraction	coral/ecosystem_structure/live_coral_fraction
Hard coral ecosystem structure - ecosystem distribution	coral/ecosystem_structure/ecosystem_distribution
Hard coral ecosystem structure - ecosystem vertical profile	coral/ecosystem_structure/ecosystem_vertical_profile
Macroalgae canopy height	macroalgae/canopy_height
Macroalgae diversity	macroalgae/diversity
Macroalgae condition	macroalgae/condition
Macroalgae stem density (kelps)	macroalgae/stem_density
Macroalgae plant size classes	macroalgae/size_classes
Macroalgae photosynthetic efficiency	macroalgae/photosynthetic_efficiency
Macroalgae photosynthetic biomass	macroalgae/photosynthetic_biomass
Macroalgae areal extent	macroalgae/areal_extent
Macroalgae genetic composition	macroalgae/genetic_composition
Macroalgae genetic composition - effective population size	macroalgae/genetic_composition/effective_population_size
Macroalgae genetic composition - genetic differentiation	macroalgae/genetic_composition/genetic_differentiation
Macroalgae genetic composition - genetic diversity	macroalgae/genetic_composition/genetic_diversity
Macroalgae genetic composition - inbreeding	macroalgae/genetic_composition/inbreeding
Macroalgae species traits	macroalgae/traits
Macroalgae species traits - morphology	macroalgae/traits/morphology
Macroalgae species traits - physiology	macroalgae/traits/physiology
Macroalgae species traits - phenology	macroalgae/traits/phenology
Macroalgae community composition	macroalgae/community_composition
Macroalgae community composition - community abundance	macroalgae/community_composition/abundance
Macroalgae community composition - taxonomic/phylogenetic diversity	macroalgae/community_composition/phylogenetic_diversity
Macroalgae community composition - trait diversity	macroalgae/community_composition/trait_diversity
Macroalgae ecosystem functioning	macroalgae/ecosystem_functioning
Macroalgae ecosystem functioning - primary productivity	macroalgae/ecosystem_functioning/primary_productivity
Macroalgae ecosystem functioning - ecosystem phenology	macroalgae/ecosystem_functioning/phenology
Macroalgae ecosystem functioning - ecosystem disturbances	macroalgae/ecosystem_functioning/ecosystem_disturbances
Macroalgae ecosystem structure	macroalgae/ecosystem_structure
Macroalgae ecosystem structure - live cover fraction	macroalgae/ecosystem_structure/live_cover_fraction
Macroalgae ecosystem structure - ecosystem distribution	macroalgae/ecosystem_structure/ecosystem_distribution
Macroalgae ecosystem structure - ecosystem vertical profile	macroalgae/ecosystem_structure/ecosystem_vertical_profile
Mangroves diversity	mangrove/diversity
Mangroves primary productivity	mangrove/primary_productivity
Mangroves canopy height	mangrove/canopy_height
Mangroves trunk girth	mangrove/trunk_girth
Mangroves composition	mangrove/composition
Mangroves zonation	mangrove/zonation
Mangroves fringe width	mangrove/fringe_width
Mangroves fringe area	mangrove/fringe_area
Mangroves density by species	mangrove/density
Mangroves soil profile	mangrove/soil_profile
Mangroves carbon/nutrient content	mangrove/carbon_nutrient_content
Mangroves 14C age	mangrove/14c_age
Mangroves sediment and water column respiration	mangrove/sediment_water_column_respiration
Mangroves intertidal fish and invertebrate densities	mangrove/intertidal_fish_invertebrates_density
Mangroves genetic composition	mangrove/genetic_composition
Mangroves genetic composition - effective population size	mangrove/genetic_composition/effective_population_size
Mangroves genetic composition - genetic differentiation	mangrove/genetic_composition/genetic_differentiation
Mangroves genetic composition - genetic diversity	mangrove/genetic_composition/genetic_diversity
Mangroves species traits	mangrove/traits
Mangroves species traits - morphology	mangrove/traits/morphology
Mangroves species traits - physiology	mangrove/traits/physiology
Mangroves species traits - phenology	mangrove/traits/phenology
Mangroves species traits - movement	mangrove/traits/movement
Mangroves community composition	mangrove/community_composition
Mangroves community composition - community abundance	mangrove/community_composition/abundance
Mangroves community composition - taxonomic/phylogenetic diversity	mangrove/community_composition/phylogenetic_diversity
Mangroves community composition - trait diversity	mangrove/community_composition/trait_diversity
Mangroves ecosystem functioning	mangrove/ecosystem_functioning
Mangroves ecosystem functioning - primary productivity	mangrove/ecosystem_functioning/primary_productivity
Mangroves ecosystem functioning - ecosystem phenology	mangrove/ecosystem_functioning/ecosystem_phenology
Mangroves ecosystem functioning - ecosystem disturbances	mangrove/ecosystem_functioning/ecosystem_disturbances
Mangroves ecosystem structure	mangrove/ecosystem_structure
Mangroves ecosystem structure - live cover fraction	mangrove/ecosystem_structure/live_cover_fraction
Mangroves ecosystem structure - ecosystem distribution	mangrove/ecosystem_structure/ecosystem_distribution
Mangroves ecosystem structure - ecosystem vertical profile	mangrove/ecosystem_structure/ecosystem_vertical_profile
Invertebrate distribution	invertebrates/distribution
Invertebrate abundance 	invertebrates/abundance
Invertebrate genetic composition	invertebrates/genetic_composition
Invertebrate genetic composition - effective population size	invertebrates/genetic_composition/effective_population_size
Invertebrate genetic composition - genetic differentiation	invertebrates/genetic_composition/genetic_differentiation
Invertebrate genetic composition - genetic diversity	invertebrates/genetic_composition/genetic_diversity
Invertebrate species traits	invertebrates/traits
Invertebrate species traits - morphology	invertebrates/traits/morphology
Invertebrate species traits - physiology	invertebrates/traits/physiology
Invertebrate species traits - phenology	invertebrates/traits/phenology
Invertebrate species traits - movement	invertebrates/traits/movement
Invertebrate community composition	invertebrates/community_composition
Invertebrate community composition - community abundance	invertebrates/community_composition/abundance
Invertebrate community composition - taxonomic/phylogenetic diversity	invertebrates/community_composition/phylogenetic_diversity
Invertebrate community composition - trait diversity	invertebrates/community_composition/trait_diversity
Invertebrate community composition - interaction diversity	invertebrates/community_composition/interaction_diversity
Invertebrate ecosystem functioning	invertebrates/ecosystem_functioning
Invertebrate ecosystem functioning - ecosystem phenology	invertebrates/ecosystem_functioning/ecosystem_phenology
Invertebrate ecosystem functioning - ecosystem disturbances	invertebrates/ecosystem_functioning/ecosystem_disturbances
Invertebrate ecosystem structure	invertebrates/ecosystem_structure
Invertebrate ecosystem structure - ecosystem distribution	invertebrates/ecosystem_structure/ecosystem_distribution
Microbe biomass	microbe/biomass
Microbe diversity	microbe/diversity
Microbe genetic composition	microbe/genetic_composition
Microbe genetic composition - effective population size	microbe/genetic_composition/effective_population_size
Microbe genetic composition - genetic differentiation	microbe/genetic_composition/genetic_differentiation
Microbe genetic composition - genetic diversity	microbe/genetic_composition/genetic_diversity
Microbe species traits	microbe/traits
Microbe species traits - morphology	microbe/traits/morphology
Microbe species traits - physiology	microbe/traits/physiology
Microbe species traits - phenology	microbe/traits/phenology
Microbe community composition	microbe/community_composition
Microbe community composition - community abundance	microbe/community_composition/abundance
Microbe community composition - taxonomic/phylogenetic diversity	microbe/community_composition/phylogenetic_diversity
Microbe community composition - trait diversity	microbe/community_composition/trait_diversity
Microbe community composition - interaction diversity	microbe/community_composition/interaction_diversity
Microbe ecosystem functioning	microbe/ecosystem_functioning
Microbe ecosystem functioning - primary productivity	microbe/ecosystem_functioning/primary_productivity
Microbe ecosystem functioning - ecosystem phenology	microbe/ecosystem_functioning/ecosystem_phenology
Microbe ecosystem functioning - ecosystem disturbances	microbe/ecosystem_functioning/ecosystem_disturbances
Microbe ecosystem structure	microbe/ecosystem_structure
Microbe ecosystem structure - ecosystem distribution	microbe/ecosystem_structure/ecosystem_distribution
Marine birds abundance	birds/abundance
Marine birds distribution	birds/distribution
Marine birds sex	birds/sex
Marine birds age	birds/age
Marine birds repeated individual presence (tracking/resights)	birds/repeated_individual_presence
Marine birds genetic composition	birds/genetic_composition
Marine birds genetic composition - effective population size	birds/genetic_composition/effective_population_size
Marine birds genetic composition - genetic differentiation	birds/genetic_composition/genetic_differentiation
Marine birds genetic composition - genetic diversity	birds/genetic_composition/genetic_diversity
Marine birds genetic composition - inbreeding	birds/genetic_composition/inbreeding
Marine birds species traits	birds/traits
Marine birds species traits - morphology	birds/traits/morphology
Marine birds species traits - physiology	birds/traits/physiology
Marine birds species traits - phenology	birds/traits/phenology
Marine birds species traits - movement	birds/traits/movement
Marine birds community composition	birds/community_composition
Marine birds community composition - community abundance	birds/community_composition/abundance
Marine birds community composition - taxonomic/phylogenetic diversity	birds/community_composition/phylogenetic_diversity
Marine birds community composition trait diversity	birds/community_composition/trait_diversity
Marine birds community composition - interaction diversity	birds/community_composition/interaction_diversity
Marine birds ecosystem functioning	birds/ecosystem_functioning
Marine birds ecosystem functioning - ecosystem phenology	birds/ecosystem_functioning/ecosystem_phenology
Marine birds ecosystem functioning - ecosystem disturbances	birds/ecosystem_functioning/ecosystem_disturbances
Marine birds ecosystem structure	birds/ecosystem_structure
Marine birds ecosystem structure - ecosystem distribution	birds/ecosystem_structure/ecosystem_distribution
Marine mammals abundance	mammals/abundance
Marine mammals distribution	mammals/distribution
Marine mammals sex	mammals/sex
Marine mammals age	mammals/age
Marine mammals repeated individual presence (tracking/resights)	mammals/repeated_individual_presence
Marine mammals genetic composition	mammals/genetic_composition
Marine mammals genetic composition - effective population size	mammals/genetic_composition/effective_population_size
Marine mammals genetic composition - genetic differentiation	mammals/genetic_composition/genetic_differentiation
Marine mammals genetic composition - genetic diversity	mammals/genetic_composition/genetic_diversity
Marine mammals genetic composition - inbreeding	mammals/genetic_composition/inbreeding
Marine mammals species traits	mammals/traits
Marine mammals species traits - morphology	mammals/traits/morphology
Marine mammals species traits - physiology	mammals/traits/physiology
Marine mammals species traits - phenology	mammals/traits/phenology
Marine mammals species traits - movement	mammals/traits/movement
Marine mammals community composition	mammals/community_composition
Marine mammals community composition - community abundance	mammals/community_composition/community_composition
Marine mammals community composition - taxonomic/phylogenetic diversity	mammals/community_composition/taxonomic_phylogenetic_diversity
Marine mammals community composition - trait diversity	mammals/community_composition/trait_diversity
Marine mammals community composition - interaction diversity	mammals/community_composition/interaction_diversity
Marine mammals ecosystem functioning	mammals/ecosystem_functioning
Marine mammals ecosystem functioning - ecosystem phenology	mammals/ecosystem_functioning/ecosystem_phenology
Marine mammals ecosystem functioning - ecosystem disturbances	mammals/ecosystem_functioning/ecosystem_disturbances
Marine mammals ecosystem structure	mammals/ecosystem_structure
Marine mammals ecosystem structure - ecosystem distribution	mammals/ecosystem_distribution
Marine turtles abundance	turtles/abundance
Marine turtles distribution	turtles/distribution
Marine turtles sex	turtles/sex
Marine turtles age	turtles/age
Marine turtles repeated individual presence (tracking/resights)	turtles/repeated_individual_presence
Marine turtles genetic composition	turtles/genetic_composition
Marine turtles genetic composition - effective population size	turtles/genetic_composition/effective_population_size
Marine turtles genetic composition - genetic differentiation	turtles/genetic_composition/genetic_differentiation
Marine turtles genetic composition - genetic diversity	turtles/genetic_composition/genetic_diversity
Marine turtles genetic composition - inbreeding	turtles/genetic_composition/inbreeding
Marine turtles species traits	turtles/traits
Marine turtles species traits - morphology	turtles/traits/morphology
Marine turtles species traits - physiology	turtles/traits/physiology
Marine turtles species traits - phenology	turtles/traits/phenology
Marine turtles species traits - movement	turtles/traits/movement
Marine turtles community composition	turtles/community_composition
Marine turtles community composition - community abundance	turtles/community_composition/abundance
Marine turtles community composition - taxonomic/phylogenetic diversity	turtles/community_composition/taxonomic_phylogenetic_diversity
Marine turtles community composition - trait diversity	turtles/community_composition/trait_diversity
Marine turtles community composition - interaction diversity	turtles/community_composition/interaction_diversity
Marine turtles ecosystem functioning	turtles/ecosystem_functioning
Marine turtles ecosystem functioning - ecosystem phenology	turtles/ecosystem_functioning/ecosystem_phenology
Marine turtles ecosystem functioning - ecosystem disturbances	turtles/ecosystem_functioning/ecosystem_disturbances
Marine turtles ecosystem structure	turtles/ecosystem_structure
Marine turtles ecosystem structure - ecosystem distribution	turtles/ecosystem_structure/ecosystem_distribution
Phytoplankton biomass	phytoplankton/biomass
Phytoplankton diversity	phytoplankton/diversity
Phytoplankton abundance	phytoplankton/abundance
Phytoplankton in vitro/in vivo pigment fluorescence	phytoplankton/pigment_fluorescence
Phytoplankton pigment concentration by spectrophotometry	phytoplankton/pigment_concentration
Phytoplankton spectral reflectance	phytoplankton/spectral_reflectance
Phytoplankton genetic composition	phytoplankton/genetic_composition
Phytoplankton genetic composition - effective population size	phytoplankton/genetic_composition/effective_population_size
Phytoplankton genetic composition - genetic differentiation	phytoplankton/genetic_composition/genetic_differentiation
Phytoplankton genetic composition - genetic diversity	phytoplankton/genetic_composition/genetic_diversity
Phytoplankton species traits	phytoplankton/traits
Phytoplankton species traits - morphology	phytoplankton/traits/morphology
Phytoplankton species traits - physiology	phytoplankton/traits/physiology
Phytoplankton species traits - phenology	phytoplankton/traits/phenology
Phytoplankton community composition	phytoplankton/community_composition
Phytoplankton community composition - community abundance	phytoplankton/community_composition/abundance
Phytoplankton community composition - taxonomic/phylogenetic diversity	phytoplankton/community_composition/taxonomic_phylogenetic_diversity
Phytoplankton community composition - trait diversity	phytoplankton/community_composition/trait_diversity
Phytoplankton community composition - interaction diversity	phytoplankton/community_composition/interaction_diversity
Phytoplankton ecosystem functioning	phytoplankton/ecosystem_functioning
Phytoplankton ecosystem functioning - primary productivity	phytoplankton/ecosystem_functioning/primary_productivity
Phytoplankton ecosystem functioning - ecosystem phenology	phytoplankton/ecosystem_functioning/ecosystem_phenology
Phytoplankton ecosystem functioning - ecosystem disturbances	phytoplankton/ecosystem_functioning/ecosystem_disturbances
Phytoplankton ecosystem structure	phytoplankton/ecosystem_structure
Phytoplankton ecosystem structure - ecosystem distribution	phytoplankton/ecosystem_structure
Zooplankton biomass	zooplankton/biomass
Zooplankton diversity	zooplankton/diversity
Zooplankton abundance	zooplankton/abundance
Zooplankton genetic composition	zooplankton/genetic_composition
Zooplankton genetic composition - effective population size	zooplankton/genetic_composition/effective_population_size
Zooplankton genetic composition - genetic differentiation	zooplankton/genetic_composition/genetic_differentiation
Zooplankton genetic composition - genetic diversity	zooplankton/genetic_composition/genetic_diversity
Zooplankton species traits	zooplankton/traits
Zooplankton species traits - morphology	zooplankton/traits/morphology
Zooplankton species traits - physiology	zooplankton/traits/physiology
Zooplankton species traits - phenology	zooplankton/traits/phenology
Zooplankton community composition	zooplankton/community_composition
Zooplankton community composition - community abundance	zooplankton/community_composition/abundance
Zooplankton community composition - taxonomic/phylogenetic diversity	zooplankton/community_composition/taxonomic_phylogenetic_diversity
Zooplankton community composition - trait diversity	zooplankton/community_composition/trait_diversity
Zooplankton community composition - interaction diversity	zooplankton/community_composition/interaction_diversity
Zooplankton ecosystem functionin	zooplankton/ecosystem_functioning
Zooplankton ecosystem functioning - primary productivity	zooplankton/ecosystem_functioning/primary_productivity
Zooplankton ecosystem functioning - ecosystem phenology	zooplankton/ecosystem_functioning/ecosystem_phenology
Zooplankton ecosystem functioning - ecosystem disturbances	zooplankton/ecosystem_functioning/ecosystem_disturbances
Zooplankton ecosystem structure	zooplankton/ecosystem_structure
Zooplankton ecosystem structure - ecosystem distribution	zooplankton/ecosystem_structure/ecosystem_distribution
Seagrass cover	seagrass/cover
Seagrass composition	seagrass/composition
Seagrass shoot density / cover	seagrass/shoot_density_cover
Seagrass canopy cover	seagrass/canopy_cover
Seagrass diversity	seagrass/diversity
Seagrass areal extent	seagrass/areal_extent
Seagrass photosynthetic efficiency	seagrass/photosynthetic_efficiency
Seagrass genetic composition	seagrass/genetic_composition
Seagrass genetic composition - effective population size	seagrass/genetic_composition/effective_population_size
Seagrass genetic composition - genetic differentiation	seagrass/genetic_composition/genetic_differentiation
Seagrass genetic composition - genetic diversity	seagrass/genetic_composition/genetic_diversity
Seagrass species traits	seagrass/traits
Seagrass species traits - morphology	seagrass/traits/morphology
Seagrass species traits - physiology	seagrass/traits/physiology
Seagrass species traits - phenology	seagrass/traits/phenology
Seagrass community composition	seagrass/community_composition
Seagrass community composition - community abundance	seagrass/community_composition/abundance
Seagrass community composition - taxonomic/phylogenetic diversity	seagrass/community_composition/taxonomic_phylogenetic_diversity
Seagrass community composition - trait diversity	seagrass/community_composition/trait_diversity
Seagrass community composition - interaction diversity	seagrass/community_composition/interaction_diversity
Seagrass ecosystem functioning	seagrass/ecosystem_functioning
Seagrass ecosystem functioning - primary productivity	seagrass/ecosystem_functioning/primary_productivity
Seagrass ecosystem functioning - ecosystem phenology	seagrass/ecosystem_functioning/ecosystem_phenology
Seagrass ecosystem functioning - ecosystem disturbances	seagrass/ecosystem_functioning/ecosystem_disturbances
Seagrass ecosystem structure	seagrass/ecosystem_structure
Seagrass ecosystem structure - live cover fraction	seagrass/ecosystem_structure/live_cover_fraction
Seagrass ecosystem structure - ecosystem distribution	seagrass/ecosystem_structure/ecosystem_distribution
Seagrass ecosystem structure - ecosystem vertical profile	seagrass/ecosystem_structure/ecosystem_vertical_profile
